##################################
#....#......#....................#
#.@..#......#....................#
#....#......#...........#...K....#
#....#......#...........#........#
##..##......##########..#........#
#...........#...........#........#
#...........#...........#........#
#...........#...........#........#
#...........#...........#........#
#...........#...........#........#
#.......................#........#
#...........#...........#........#
##################################    
